1 1 1 1 1 1 1 1 1 1 1 1 1 1 1 1 1 1 1 1 1 1 1 1 1
1 0 0 9 9 9 9 9 9 9 9 9 9 9 9 9 9 9 9 9 9 9 0 0 1
1 0 0 9 9 9 9 9 9 9 9 9 9 9 9 9 9 9 9 9 9 9 0 0 1
1 0 0 9 9 4 4 4 4 4 4 4 4 4 4 4 4 4 4 4 9 9 0 0 1
1 0 0 9 9 4 4 4 4 4 4 4 4 4 4 4 4 4 4 4 9 9 0 0 1
1 0 0 9 9 4 4 4 4 4 8 8 8 8 8 4 4 4 4 4 9 9 0 0 1
1 0 0 9 9 4 4 4 4 4 8 8 8 8 8 4 4 4 4 4 9 9 0 0 1
1 0 0 9 9 4 4 4 8 8 8 8 8 8 8 8 8 4 4 4 9 9 0 0 1
1 0 0 0 0 4 4 8 8 8 8 8 8 8 8 8 8 8 4 4 0 0 0 0 1
1 0 0 0 0 4 4 8 8 8 8 8 8 8 8 8 8 8 4 4 0 0 0 0 1
1 0 0 0 0 4 4 8 8 8 8 8 8 8 8 8 8 8 4 4 0 0 0 0 1
1 0 0 0 0 4 4 8 8 8 8 8 8 8 8 8 8 8 4 4 0 0 0 0 1
1 0 0 9 9 4 4 4 8 8 8 8 8 8 8 8 8 4 4 4 9 9 0 0 1
1 0 0 9 9 4 4 4 4 4 8 8 8 8 8 4 4 4 4 4 9 9 0 0 1
1 0 0 9 9 4 4 4 4 4 8 8 8 8 8 4 4 4 4 4 9 9 0 0 1
1 0 0 9 9 4 4 4 4 4 4 4 4 4 4 4 4 4 4 4 9 9 0 0 1
1 0 0 9 9 4 4 4 4 4 4 4 4 4 4 4 4 4 4 4 9 9 0 0 1
1 0 0 9 9 9 9 9 9 9 9 9 9 9 9 9 9 9 9 9 9 9 0 0 1
1 0 0 9 9 9 9 9 9 9 9 9 9 9 9 9 9 9 9 9 9 9 0 0 1
1 1 1 1 1 1 1 1 1 1 1 1 1 1 1 1 1 1 1 1 1 1 1 1 1