1 1 3 3 1 1 1 1 1 1 1 1 1 1 1 1 1 1 1 1 1 3 3 1 1
1 0 2 2 0 0 8 8 8 8 8 8 8 0 0 0 0 0 0 0 0 2 2 0 1
1 0 2 2 0 6 0 8 8 8 8 8 8 0 0 0 0 0 0 0 0 2 2 0 1
1 0 2 2 0 0 0 0 8 8 8 8 8 8 0 0 0 0 0 0 0 2 2 0 1
1 0 2 2 0 6 0 0 0 8 8 8 8 8 8 0 0 0 0 0 0 2 2 0 1
1 0 2 2 0 0 0 0 0 8 8 8 8 8 8 0 0 6 0 6 0 2 2 0 1
1 0 2 2 0 6 0 6 0 0 8 8 8 8 8 8 0 0 0 0 0 2 2 0 1
1 0 2 2 0 0 0 0 0 0 8 8 8 8 8 8 0 6 0 6 0 2 2 0 1
1 0 2 2 0 0 0 0 0 0 0 8 8 8 8 8 8 0 0 0 0 2 2 0 1
3 2 2 2 2 2 2 2 2 2 2 2 2 2 2 2 2 2 2 2 2 2 2 2 3
3 2 2 2 2 2 2 2 2 2 2 2 2 2 2 2 2 2 2 2 2 2 2 2 3
1 0 2 2 0 0 0 0 0 0 0 8 8 8 8 8 8 0 0 0 0 2 2 0 1
1 0 2 2 0 6 0 6 0 0 8 8 8 8 8 8 0 6 0 6 0 2 2 0 1
1 0 2 2 0 0 0 0 0 0 8 8 8 8 8 8 0 0 0 0 0 2 2 0 1
1 0 2 2 0 6 0 0 0 8 8 8 8 8 8 8 0 6 0 6 0 2 2 0 1
1 0 2 2 0 0 0 0 8 8 8 8 8 8 8 0 0 0 0 0 0 2 2 0 1
1 0 2 2 0 6 0 0 8 8 8 8 8 8 8 0 0 0 0 0 0 2 2 0 1
1 0 2 2 0 0 0 8 8 8 8 8 8 8 8 0 0 0 0 0 0 2 2 0 1
1 0 2 2 0 0 8 8 8 8 8 8 8 8 0 0 0 0 0 0 0 2 2 0 1
1 1 3 3 1 1 1 1 1 1 1 1 1 1 1 1 1 1 1 1 1 3 3 1 1