3 3 3 3 3 3 3 3 3 3 3 3 3 3 3 3 3 3 3 3 3 3 3 3 3
3 2 2 2 2 2 2 2 2 2 2 2 2 2 2 2 2 2 2 2 2 2 2 2 3
3 2 3 2 7 7 7 7 7 7 7 2 6 2 6 2 6 2 7 7 7 7 2 2 3
3 2 2 2 7 2 2 2 2 2 7 2 2 2 2 2 2 2 2 2 2 7 2 2 3
3 2 3 2 7 2 6 2 6 2 7 2 6 2 6 2 6 2 2 6 2 7 2 2 3
3 2 2 2 2 2 2 2 2 2 7 2 2 2 2 2 2 2 2 2 2 7 2 2 3
3 2 3 2 7 2 6 2 6 2 7 2 6 2 6 2 6 2 2 6 2 7 2 2 3
3 2 3 2 7 2 2 2 2 2 7 2 2 2 2 2 2 2 2 2 2 7 2 2 3
3 2 3 2 7 7 7 7 7 7 7 2 3 2 2 2 3 2 2 6 2 7 2 2 3
3 2 2 2 2 2 2 2 2 2 2 2 3 2 2 2 3 2 2 2 2 2 2 2 3
3 2 2 2 2 2 2 2 2 2 2 2 3 2 2 2 3 2 2 2 2 2 2 2 3
3 2 3 2 7 7 7 7 7 7 7 2 2 2 2 2 2 2 2 6 2 7 2 2 3
3 2 3 2 7 2 2 2 2 2 7 2 2 2 2 2 2 2 2 2 2 7 2 2 3
3 2 3 2 7 2 6 2 6 2 7 2 6 2 6 2 6 2 2 6 2 7 2 2 3
3 2 2 2 2 2 2 2 2 2 7 2 2 2 2 2 2 2 2 2 2 7 2 2 3
3 2 3 2 7 2 6 2 6 2 7 2 6 2 6 2 6 2 2 6 2 7 2 2 3
3 2 2 2 7 2 2 2 2 2 7 2 2 2 2 2 2 2 2 2 2 7 2 2 3
3 2 3 2 7 7 7 7 7 7 7 2 6 2 6 2 6 2 7 7 7 7 2 2 3
3 2 2 2 2 2 2 2 2 2 2 2 2 2 2 2 2 2 2 2 2 2 2 2 3
3 3 3 3 3 3 3 3 3 3 3 3 3 3 3 3 3 3 3 3 3 3 3 3 3